
ti-nl-ba-bk = Bachelor of Science in de industriële wetenschappen: bouwkunde
ti-nl-ba-ch = Bachelor of Science in de industriële wetenschappen: chemie
ti-nl-ba-em = Bachelor of Science in de industriële wetenschappen: elektromechanica
ti-nl-ba-ei = Bachelor of Science in de industriële wetenschappen: elektronica-ICT
ti-nl-ma-bk = Master of Science in de industriële wetenschappen: bouwkunde
ti-nl-ma-bch = Master of Science in de industriële wetenschappen: biochemie
ti-nl-ma-ch = Master of Science in de industriële wetenschappen: chemie
ti-nl-ma-em = Master of Science in de industriële wetenschappen: elektromechanica
ti-nl-ma-ei = Master of Science in de industriële wetenschappen: elektronica-ICT
ti-en-ma-ei = Master of Science in Electronics and ICT Engineering Technology
ti-nl-eduma-wtstem = Educatieve master of Science in de wetenschappen en technologie: STEM
we-nl-eduma-wtstem = Educatieve master of Science in de wetenschappen en technologie: STEM
we-nl-eduma-wtbchbt = Educatieve master of Science in de wetenschappen en technologie: biochemie en biotechnologie
we-nl-eduma-wtbio = Educatieve master of Science in de wetenschappen en technologie: biologie
we-nl-eduma-wtch = Educatieve master of Science in de wetenschappen en technologie: chemie
we-nl-eduma-wtfy = Educatieve master of Science in de wetenschappen en technologie: fysica
we-nl-eduma-wtinf = Educatieve master of Science in de wetenschappen en technologie: informatica
we-nl-eduma-wtwi = Educatieve master of Science in de wetenschappen en technologie: wiskunde
we-nl-ba-bircg = Bachelor of Science in de bio-ingenieurswetenschappen: cel- en genbiotechnologie
we-nl-ba-birvt = Bachelor of Science in de bio-ingenieurswetenschappen: chemie en voedingstechnologie
we-nl-ba-birlb = Bachelor of Science in de bio-ingenieurswetenschappen: land- en bosbeheer
we-nl-ba-birmt = Bachelor of Science in de bio-ingenieurswetenschappen: milieutechnologie
we-nl-ba-bio = Bachelor of Science in de biologie
we-nl-ma-bioeg = Master of Science in de biologie: evolutie en gedragsbiologie
we-en-ma-biocr = Master of Science in biology: biodiversity, conservation and restoration
we-en-ma-biogcb = Master of Science in biology: global change biology
we-en-ma-biomb = Master of Science in molecular biology
we-nl-ba-ch = Bachelor of Science in de chemie
we-en-ma-ch = Master of Science in chemistry
we-nl-ba-inf = Bachelor of Science in de informatica
we-en-ma-infcn = Master of Science in computer science: computer networks
we-en-ma-infdsai = Master of Science in computer science: data science and artificial intelligence
we-en-ma-infse = Master of Science in computer science: software engineering
we-nl-ma-infcn = Master of Science in de informatica: computernetwerken
we-nl-ma-infdsai = Master of Science in de informatica: data science en artificiële intelligentie
we-nl-ma-infse = Master of Science in de informatica: software engineering
we-nl-ba-fy = Bachelor of Science in de fysica
we-nl-ma-fy = Master of Science in de fysica
we-en-ma-fy = Master of Science in physics
we-nl-ba-wi = Master of Science in wiskunde
we-nl-ma-wifw = Master of Science in wiskunde: fundamentele wiskunde
we-nl-ma-wiftw = Master of Science in wiskunde: financiële en toegepaste wiskunde

